0 0 10 10
00 00 00 00 00 00 00 00 00 00 
00 00 00 00 00 00 00 00 00 00 
00 00 00 00 04 04 00 00 00 00 
00 00 00 04 00 00 00 00 00 00 
00 00 00 04 00 00 00 00 00 00 
00 00 00 04 04 04 00 00 00 00 
00 00 00 04 00 00 04 00 00 00 
00 00 00 04 00 00 04 00 00 00 
00 00 00 04 04 04 00 00 00 00 
04 04 04 04 04 04 04 04 04 04 
